OOWWWWWWOOOOO
OWWPWWPWOOOOO
OWWPWWWWOOOWO
OWPPPPWWWWWPW
OWPPPPWPWPPWW
OWPPPPPPWPPWO
WPPMMMPPPWWOO
WPPPMWPPPWWOO
WWPPPPPPPWWWO
WPPPPPPPPPPWO
WPPWPSMMPPPWO
WWPPWSSMMPPWO
OWPPMMSMMPWWO
WWWPPPSWPPWWO
OWPPPPPPPPPWO
OWDDDPPPPPPPW
WWDDDDPPPPPWW
WWDDDDPPPPPWO
OWWWDDPWPPPWO
OWWWWWPWWWWWO
OOOOOWWOWWOOO
